0000000000000000000000000000000000000000000000000000000
0020111111111110111111111011111111111111111111111011100
0010100000000010100000101000001000000000000000001010100
0010111010111110101111101111111011101111111110101010100
0010001010100000001000000000000010001000001010101010100
0011111010111111101011111011101111111011111011101010100
0000000010000000101010001010100010000010000000101000100
0011111110111111101111101110111011101110111011101110100
0010000000100000000000000000001000001000100010000010100
0011111111101110111111101111111011111011101110111110100
0010000000001010101000101000000010000010001000100000100
0011111110111010101011101011101110111110111110101110100
0000000010001010101010001010001010000010100000101010100
0010111011111010101011111010111010111011101011101011100
0010101000000010001000000010100010101010001010001000100
0011101111111011101011111111101011101011111010111010100
0010000000100000101010000000001000001000001010100010100
0010111110101110101011111111101110111011101010111010100
0010100010101010101000000000100010100010100010001010100
0011101110111011111011111111111110111110111111111011300
0000000000000000000000000000000000000000000000000000000
